111111111111111
100000000000001
100000000000001
100000000000001
100000000000001
100000000000001
100000000000001
100000000000001
100000000000001
100000000000001
100C00000000001
101110000000001
100000000000001
100000000000001
111111111111111
